2 2 2 2 2 2 2 2 2 2 2 2 2 2 2 2
2 9 9 9 9 9 2 9 9 9 9 9 9 9 9 2
2 9 9 9 9 9 9 9 9 9 9 9 9 9 9 2
2 9 9 9 9 9 2 9 9 9 9 9 9 9 9 2
2 9 2 2 2 2 2 2 2 2 2 2 2 2 2 2
2 9 2 2 2 2 2 9 2 2 2 2 2 2 2 2
11 9 9 9 9 9 9 9 9 9 9 9 9 9 9 2
2 2 2 9 2 2 2 2 2 2 2 9 2 2 9 2
2 2 2 2 2 2 2 2 2 2 2 2 2 2 9 2
2 9 9 9 9 9 9 9 9 9 9 9 9 9 9 10
2 9 9 9 9 9 9 9 9 9 9 9 9 9 9 10
2 2 9 9 2 2 2 2 2 2 2 2 2 2 2 2