1 1 1 1 1 1 16 4 4 15 1 1 1 1 1 1
1 1 1 1 1 1 16 4 4 15 1 1 1 1 1 1
1 1 1 1 1 1 16 4 4 15 1 1 1 1 1 1
1 1 1 1 1 1 16 4 4 15 1 1 1 1 1 1
0 0 0 0 0 0 0 0 0 0 0 0 0 0 0 0
14 14 14 14 14 14 14 14 14 14 14 14 14 14 14 14
13 13 13 13 13 13 13 13 13 13 13 13 13 13 13 13
0 6 0 0 0 6 0 0 0 0 6 0 0 6 0 0
0 0 0 0 0 0 0 0 0 0 0 0 0 0 0 0
3 3 3 3 3 3 3 3 3 3 3 3 3 3 3 3
0 0 0 0 0 0 0 0 0 0 0 0 0 0 0 0 
0 0 0 0 0 0 0 0 0 0 0 0 0 0 0 0 