6 6 6 6 8 8 8 8 8 8 8 8 6 6 6 6 
7 7 7 7 7 7 7 7 7 7 7 7 7 7 7 7
14 14 14 14 14 14 14 14 14 14 14 14 14 14 14 14
3 3 3 3 3 3 3 3 3 3 3 3 3 3 3 3
13 13 13 13 13 13 13 13 13 13 13 13 13 13 13 13
0 0 0 0 6 0 0 6 6 0 0 6 0 0 0 0 
14 14 14 14 14 14 14 14 14 14 14 14 14 14 14 14
3 3 3 3 3 3 3 3 3 3 3 3 3 3 3 3
13 13 13 13 13 13 13 13 13 13 13 13 13 13 13 13
0 0 0 0 0 0 0 0 0 0 0 0 0 0 0 0
1 1 1 1 1 1 16 4 4 15 1 1 1 1 1 1
1 1 1 1 1 1 16 4 4 15 1 1 1 1 1 1





